0000000X0000000
0000000:0000000
000000000000000
000000010000000
0000000Z0000000
000000111000000
000001111100000
000011121110000
000011111111110
000011111110010
0000M66966M0010
000011121110010
000001111100010
000011111110010
000011111111110
000011121110010
000011111110111
0000111111101;1
000011111110111
000011111110000
000011111110000