1110X10111
1110:10111
1111ZZ1111
11111>1111
10111111M1
1111111141
1111111191
1110111141
11111111M1