00M6696666666M111110
00111111000000111110
00000001000000001000
00000001000000001000
01110001000000001000
01111111010101001000
01100111111Z1111Z;00
00110111000001011000
01110111111111011000
01110111111111011000
01110101000000011000
00000101111111111000
01000101000000100000
01X00101000000100000
01:00111000001100000
00000111000000000000