011011011011011
1566666666666M1
136666696667111
100156666668110
;11140056711100
101036681366710
000000001111M11
000000001001111
000000001100001
01110000Z111101
11X11000101Z101
11:111001110001
011100001000111