0111100011110001100000
1M1;001X:1111001Z11110
0367100011110001Z01110
0014100000000001100000
0013671100000001100000
0111136711111111011110
0100000411111111111110
0101110410111111111110
1105666810101110110011
1019100000101101101101
1103666666701101101101
0101100000401011110011
0100001M10411111111110
0111111366811000000000