11111111115666666666669111
11156666668566666666668111
11141111111410000000111111
1113666711136666666M111111
11566668111111111111111111
1141111111111;111111111111
11411110000011111000000000
11411110111011101000000000
114111001L101100100001<111
11411101111000011000010001
11411101L111111Z1000010:X0
114111011100000Z1001110111
11M11100000111011000010001
11111111111111000000011111