111111001111111111111
1M6671001566666667571
111141001456666674441
111136666836666739441
111111111110001366841
100000111110;01111141
101110011100100111141
101Z11011110101111141
1001Z1011111111111141
110001111111111111141
000000000111000000141
000000000111111111141
000001000111000000141
111111000111000000141
1:11110001110000001M1
1X1111000000000000000