111111111111111111111111
1111156666666666666M1111
111114110000011111111111
000004110111011111111111
156668110101011111;11111
191000000111011111111111
14111111010Z011000000000
136666670111011000000000
15666668010Z00000001111<
136666670111111000110001
11566668000Z001000011<01
1140000011011110000<0100
11366M11110000100001010X
11111111111111100001=11: