1111111111111111111111
11M6666666666666666667
1111000000000056666668
1;11015666666681111111
1111013666669666666711
1111000000000000001411
1566666666666666666811
1366666666666666666671
1115666666666666666681
1113666666666666667111
0000000000111111114111
X:11100000111111114111
0000110000111111114111
0111110000111000114111
1101000000000011014111
0001010000111Z11014111
1111010000111Z11014111
1011010001111Z11014111
100001000010000001M111
1111110000111111111111