1111111111111111FHHF
111111111111111111DF
11111111111111111111
11111111111111111111
1111111111BBBBB11111
11111111111111B1C11C
11111111111111BC1C1C
1111111111BBBBB11111
11111111111111111111
11111111111111111111
11111111111111111111
111111L11L1111111111
111111L11L1111111111
NNNNNNN88NNNNNNNNNNN
88888888888888888888
88888888888888888888
88888888888888888888
88888888888888888888
88888888888888888888
NNNNNNN88NNNNNNNNNNN
88888888888888888888
88888888888888888888
B8BB8BB88B8BB8BB8BB8
88B8BB8B88BB8BB8BB8B