3,3,3,3,3,3,3,3,3,3,3,3,3
3,0,0,0,0,0,0,0,0,0,0,0,3
3,0,4,0,0,4,4,4,0,0,1,1,3
3,0,4,0,0,4,4,4,0,0,1,1,3
3,0,4,0,0,0,4,4,4,0,0,0,3
3,0,2,2,1,1,3,0,0,0,0,0,3
3,1,2,3,3,3,0,0,1,1,0,0,3
3,1,2,2,0,4,4,4,0,0,0,1,3
3,1,2,2,0,0,0,0,4,4,0,1,3
3,1,2,4,0,4,4,4,0,0,0,1,3
3,0,0,0,0,4,5,4,0,0,0,0,3
3,3,3,3,3,3,3,3,3,3,3,3,3