4,4,4,4,4,4,4,4,4,4
4,1,1,2,3,2,1,3,2,4
4,2,3,1,2,3,4,2,3,4
4,3,1,2,3,4,5,5,5,4
4,3,1,3,3,7,1,2,1,4
4,3,1,2,3,1,3,1,2,4
4,2,2,2,3,1,3,1,2,4
4,1,1,2,3,1,3,3,2,4
4,2,5,2,3,1,3,3,3,4
4,4,4,4,4,4,4,4,4,4
