1111221BAB222BB23333
2211221BAB222BB23CC3
1BBD222BAB222BB23BA3
1BBD222CCC222BB23333
1DDDC22DDC222BB23333
1C33B222222222222222
1C33A2222222E2222222
1C33B22222222222DDDD
2CAAC222222222221111
22222222222222221111
2222222222222DDD1111
22222222222222221111
22ABBBB22BBB22BA1111
22CBADB22AAB22BB1111
22C333B22B1111111111
22C333B22B1111111111
22C333C22B1122221122
22C333C221112332112D
22A333C221112332112D
22AAAAA221112332112D